gid,gisjoin,total_pop,native_pop,forgn_pop,forgn_pct,res_tickets
251,G17003105203003,1129,718,411,0.36404,1
2026,G17003102420002,1802,1515,287,0.15927,3
264,G17003103510001,1011,970,41,0.04055,21
1070,G17003103907002,1466,1377,89,0.06071,18
1350,G17003103812002,1302,1265,37,0.02842,23
1209,G17003107104005,1129,1066,63,0.0558,3
496,G17003102517001,1805,1668,137,0.0759,2
2311,G17003107107001,555,553,2,0.0036,1
1101,G17003107304004,908,908,0,0,1
276,G17003105302002,1330,1330,0,0,2
599,G17003100608001,1532,1242,290,0.1893,8
2285,G17003107506002,959,959,0,0,1
1789,G17003102003002,1070,615,455,0.42523,7
2247,G17003106713003,388,388,0,0,1
1820,G17003101002005,763,637,126,0.16514,43
437,G17003108122004,855,727,128,0.14971,3
1283,G17003107608033,1807,876,931,0.51522,343
2310,G17003107106001,1019,1019,0,0,25
1314,G17003107505004,1655,1655,0,0,1
25,G17003104105002,1373,1330,43,0.03132,3
359,G17003104603023,739,704,35,0.04736,17
1060,G17003106304002,1661,808,853,0.51355,2
26,G17003104106002,942,828,114,0.12102,7
2328,G17003102432001,1228,932,296,0.24104,7
1478,G17003108331003,2672,2297,375,0.14034,1
1543,G17003101001002,1724,1243,481,0.279,25
1229,G17003100702002,1013,1013,0,0,3
1662,G17003102415002,777,626,151,0.19434,1
136,G17003104212001,949,949,0,0,10
2150,G17003106605004,1630,958,672,0.41227,11
1741,G17003101609001,1347,1033,314,0.23311,3
2261,G17003100622002,1394,1346,48,0.03443,4
1726,G17003101601001,1558,1140,418,0.26829,17
1171,G17003100315013,1221,867,354,0.28993,79
2206,G17003108308002,520,414,106,0.20385,3
1146,G17003103302001,827,539,288,0.34825,1
667,G17003100308001,1191,972,219,0.18388,5
449,G17003102306002,1558,1476,82,0.05263,1
899,G17003102426004,1425,1362,63,0.04421,2
149,G17003105804001,1185,732,453,0.38228,4
307,G17003106103001,2244,1324,920,0.40998,5
706,G17003100715004,1107,969,138,0.12466,2
541,G17003102515004,1519,1506,13,0.00856,1
1582,G17003101502002,1665,1008,657,0.39459,224
1100,G17003106501004,789,495,294,0.37262,4
1408,G17003106503014,1274,891,383,0.30063,3
1065,G17003108430001,1704,1704,0,0,4
537,G17003100313003,596,321,275,0.46141,9
2300,G17003107104002,686,686,0,0,1
489,G17003100106002,844,599,245,0.29028,120
974,G17003108398003,846,616,230,0.27187,1
1757,G17003101708001,1207,767,440,0.36454,3
1320,G17003100701013,1169,1053,116,0.09923,3
357,G17003104603021,934,905,29,0.03105,15
241,G17003104402022,982,962,20,0.02037,2
958,G17003100602001,892,829,63,0.07063,4
325,G17003104601004,798,586,212,0.26566,57
17,G17003108431001,1672,1627,45,0.02691,1
1021,G17003104605003,1003,1003,0,0,5
142,G17003104914001,521,521,0,0,2
1999,G17003102405001,2154,1857,297,0.13788,3
861,G17003101708003,1384,883,501,0.36199,32
1333,G17003102206024,1898,1640,258,0.13593,2
816,G17003102002001,1035,685,350,0.33816,1
1783,G17003100818001,3435,2954,481,0.14003,1
1079,G17003104804002,513,479,34,0.06628,2
1740,G17003101608005,1164,765,399,0.34278,11
524,G17003100313001,1242,702,540,0.43478,123
644,G17003108315001,2141,1049,1092,0.51004,17
296,G17003108343003,411,381,30,0.07299,1
282,G17003108399001,638,552,86,0.1348,4
1389,G17003107608032,1714,815,899,0.5245,25
655,G17003108324002,1326,1003,323,0.24359,3
2019,G17003106715002,1460,1366,94,0.06438,9
617,G17003107102002,852,852,0,0,1
995,G17003101404003,1110,724,386,0.34775,14
167,G17003104302003,1030,931,99,0.09612,10
1569,G17003101907022,2267,1137,1130,0.49846,1
2266,G17003100628003,1429,1341,88,0.06158,1
1488,G17003100202003,1689,1245,444,0.26288,57
1982,G17003108356002,399,399,0,0,1
458,G17003108439001,638,635,3,0.0047,7
198,G17003104306001,705,702,3,0.00426,15
71,G17003104110003,1375,1114,261,0.18982,3
588,G17003106604002,1877,1157,720,0.38359,11
1606,G17003105805012,648,419,229,0.3534,1
1026,G17003104607003,389,292,97,0.24936,8
624,G17003107608021,2401,1826,575,0.23948,27
626,G17003104601002,1134,1076,58,0.05115,57
1264,G17003107307002,1143,1137,6,0.00525,2
823,G17003101303001,552,116,436,0.78986,134
1528,G17003107003022,979,790,189,0.19305,1
480,G17003100632004,1395,947,448,0.32115,3
280,G17003108398002,1114,714,400,0.35907,5
1981,G17003108356001,551,549,2,0.00363,1
314,G17003102520001,776,714,62,0.0799,4
1902,G17003101503001,1032,802,230,0.22287,25
595,G17003100307032,544,182,362,0.66544,5
1717,G17003101508004,1581,1304,277,0.17521,13
1958,G17003101705004,1110,829,281,0.25315,5
1458,G17003100206024,1116,725,391,0.35036,35
211,G17003108403003,2530,1454,1076,0.4253,13
2329,G17003102504003,1794,1706,88,0.04905,1
1963,G17003102209013,1342,866,476,0.35469,3
1800,G17003100902001,1105,1003,102,0.09231,9
77,G17003104907003,1478,1448,30,0.0203,1
153,G17003105805014,1082,558,524,0.48429,3
2004,G17003102315005,1544,1446,98,0.06347,2
56,G17003108414002,587,583,4,0.00681,1
1966,G17003102107003,1725,1154,571,0.33101,7
729,G17003101101001,1805,1612,193,0.10693,145
2183,G17003106608005,1958,1227,731,0.37334,4
1045,G17003102838001,458,423,35,0.07642,2
2211,G17003100503003,766,675,91,0.1188,1
891,G17003101904011,1548,938,610,0.39406,2
468,G17003102428001,1515,1136,379,0.25017,12
2112,G17003100308002,1074,988,86,0.08007,28
1180,G17003100620001,1969,1732,237,0.12037,1
712,G17003101006001,1090,846,244,0.22385,23
1306,G17003103302002,2929,2503,426,0.14544,1
923,G17003102214001,837,553,284,0.33931,1
1910,G17003101507001,1091,802,289,0.26489,22
952,G17003102433001,942,785,157,0.16667,1
977,G17003101908004,1693,1177,516,0.30478,1
376,G17003106117003,675,635,40,0.05926,2
879,G17003100204003,1908,1134,774,0.40566,839
1427,G17003100102022,1075,686,389,0.36186,198
515,G17003100106003,1455,1173,282,0.19381,55
2323,G17003107111002,951,951,0,0,1
2044,G17003100207023,1870,837,1033,0.55241,80
303,G17003105303004,1512,1512,0,0,2
1551,G17003105102003,1154,968,186,0.16118,2
1296,G17003104101002,1180,966,214,0.18136,12
1611,G17003101404005,1718,1080,638,0.37136,12
1131,G17003108398001,693,524,169,0.24387,1
165,G17003103206002,2376,1999,377,0.15867,1
21,G17003104008001,986,986,0,0,1
1729,G17003101603001,1734,1014,720,0.41522,44
570,G17003105603001,1817,1293,524,0.28839,17
281,G17003108400001,1901,1366,535,0.28143,2
1274,G17003100301023,1127,835,292,0.25909,52
822,G17003101002003,1488,1331,157,0.10551,5
896,G17003102203002,1027,942,85,0.08277,1
609,G17003108388002,2442,1937,505,0.2068,5
1553,G17003106305003,1432,697,735,0.51327,1
1486,G17003105805023,2193,1182,1011,0.46101,9
429,G17003108055022,808,797,11,0.01361,1
718,G17003106502003,1208,885,323,0.26738,2
694,G17003108307002,710,539,171,0.24085,124
1806,G17003101001005,1371,1072,299,0.21809,8
2153,G17003106606003,1189,942,247,0.20774,6
863,G17003101710002,1295,875,420,0.32432,11
1136,G17003101906023,1521,927,594,0.39053,1
1029,G17003105501003,1584,1284,300,0.18939,1
1776,G17003101906012,1062,581,481,0.45292,1
1575,G17003102105022,1964,1056,908,0.46232,6
530,G17003100205004,1344,583,761,0.56622,91
221,G17003104313013,1521,1468,53,0.03485,16
1405,G17003108391002,2033,1716,317,0.15593,2
2124,G17003108350004,1569,1314,255,0.16252,1
108,G17003104910001,600,600,0,0,1
643,G17003105611005,965,850,115,0.11917,8
65,G17003103108003,2295,1306,989,0.43094,3
1475,G17003108374002,1074,1055,19,0.01769,1
1885,G17003108421005,900,900,0,0,1
2326,G17003107112002,994,994,0,0,9
1017,G17003103901001,1386,1307,79,0.057,19
1832,G17003102205002,814,757,57,0.07002,1
2191,G17003106611002,850,778,72,0.08471,1
1978,G17003108364003,1023,980,43,0.04203,19
358,G17003104603022,660,564,96,0.14545,2
1181,G17003100631001,1344,1209,135,0.10045,4
941,G17003104303002,601,601,0,0,1
289,G17003103602001,1616,1302,314,0.19431,54
1819,G17003101002004,868,789,79,0.09101,13
804,G17003101613004,1361,965,396,0.29096,3
232,G17003106004003,1947,1160,787,0.40421,3
692,G17003100314002,832,772,60,0.07212,6
739,G17003101508003,1248,788,460,0.36859,15
803,G17003101613003,719,470,249,0.34631,4
1091,G17003100402023,1305,465,840,0.64368,129
1633,G17003100804003,1494,1177,317,0.21218,17
1934,G17003104402014,1503,1503,0,0,24
1018,G17003103902001,999,923,76,0.07608,13
68,G17003103109003,1833,1001,832,0.4539,2
535,G17003100306012,1035,604,431,0.41643,57
1233,G17003100803004,1308,1110,198,0.15138,12
1952,G17003104301014,1358,1358,0,0,9
2274,G17003108349001,836,831,5,0.00598,8
928,G17003104106001,1423,1304,119,0.08363,24
1812,G17003102106023,1757,1259,498,0.28344,11
1629,G17003108355001,683,677,6,0.00878,1
1733,G17003101606021,1310,1044,266,0.20305,14
2174,G17003100401003,1023,940,83,0.08113,20
202,G17003104309001,922,892,30,0.03254,30
865,G17003101710005,1336,962,374,0.27994,10
987,G17003104302002,576,545,31,0.05382,1
2102,G17003106903001,616,612,4,0.00649,5
2069,G17003100101001,421,421,0,0,13
1432,G17003104403002,1531,1528,3,0.00196,33
1721,G17003101511002,1383,711,672,0.4859,11
1595,G17003108404001,1318,919,399,0.30273,3
318,G17003102819001,1220,1040,180,0.14754,2
312,G17003102518001,1260,1260,0,0,4
2034,G17003102430001,688,566,122,0.17733,1
470,G17003102430002,1710,1251,459,0.26842,3
876,G17003108306001,965,723,242,0.25078,95
1213,G17003107114002,649,644,5,0.0077,1
1564,G17003108407003,1939,1046,893,0.46055,2
1415,G17003102207022,810,641,169,0.20864,6
1301,G17003105702001,1878,1116,762,0.40575,12
175,G17003104304004,1124,1110,14,0.01246,1
1418,G17003108367002,1173,1024,149,0.12702,9
99,G17003104204001,1216,1037,179,0.1472,2
1005,G17003100314005,1161,1008,153,0.13178,14
1884,G17003101401001,1935,978,957,0.49457,189
699,G17003100402012,1580,952,628,0.39747,84
94,G17003108412003,2161,1231,930,0.43036,1
1951,G17003104301013,810,810,0,0,17
362,G17003104603012,660,553,107,0.16212,19
1762,G17003101801003,1398,679,719,0.51431,1
1322,G17003101406022,2093,1250,843,0.40277,5
1588,G17003105302005,968,968,0,0,3
2260,G17003100622001,1593,1546,47,0.0295,32
1271,G17003103018022,1081,710,371,0.3432,2
514,G17003100104003,2240,1938,302,0.13482,275
1995,G17003103011002,1872,1026,846,0.45192,1
1040,G17003102516002,789,789,0,0,3
1244,G17003100803001,584,571,13,0.02226,2
1426,G17003103009001,1466,798,668,0.45566,1
1511,G17003108333001,2442,2007,435,0.17813,1
1130,G17003101503004,847,705,142,0.16765,45
988,G17003102506004,1347,1347,0,0,4
670,G17003100311001,1944,1778,166,0.08539,23
560,G17003108438002,978,876,102,0.10429,32
2299,G17003107104001,909,909,0,0,3
1868,G17003101201004,1055,926,129,0.12227,1
697,G17003100402024,1677,1125,552,0.32916,152
1761,G17003101801002,746,376,370,0.49598,1
1433,G17003106913002,1495,1389,106,0.0709,1
1979,G17003108355002,910,826,84,0.09231,2
1190,G17003100621002,1102,1083,19,0.01724,1
1339,G17003103012003,1862,1136,726,0.3899,2
2177,G17003108308001,809,725,84,0.10383,5
811,G17003101912001,2916,1691,1225,0.4201,4
417,G17003108076003,927,334,593,0.6397,9
605,G17003108321003,859,805,54,0.06286,5
710,G17003101003006,1203,1031,172,0.14298,2
1240,G17003100714003,1219,957,262,0.21493,1
2035,G17003102431001,2062,1264,798,0.387,7
2291,G17003106720002,703,703,0,0,2
1438,G17003107302012,890,888,2,0.00225,6
639,G17003100208022,2285,640,1645,0.71991,210
187,G17003105806003,1236,602,634,0.51294,1
1367,G17003108326002,992,959,33,0.03327,3
1770,G17003101903002,1569,937,632,0.4028,4
1623,G17003105807002,4033,2354,1679,0.41632,1
2303,G17003100716001,1715,1507,208,0.12128,2
1504,G17003108351002,1149,558,591,0.51436,10
2013,G17003106709002,990,990,0,0,2
126,G17003103008002,2689,1126,1563,0.58126,2
511,G17003108340002,893,893,0,0,3
1313,G17003107505003,2128,2128,0,0,6
968,G17003108318003,1493,1039,454,0.30409,99
2085,G17003100303001,1450,798,652,0.44966,451
378,G17003102512003,617,617,0,0,14
2282,G17003107505001,1567,1451,116,0.07403,2
1880,G17003101301001,958,557,401,0.41858,35
742,G17003101601002,1068,700,368,0.34457,2
1176,G17003100404013,663,475,188,0.28356,1
788,G17003100601003,772,653,119,0.15415,1
1423,G17003100307061,2157,1558,599,0.2777,10
1032,G17003106201002,1768,1048,720,0.40724,8
1004,G17003108439005,652,617,35,0.05368,32
2161,G17003106909005,1068,1038,30,0.02809,5
477,G17003108340001,2723,2674,49,0.01799,2
1905,G17003101504011,1496,795,701,0.46858,22
1165,G17003103802002,1558,1526,32,0.02054,5
1441,G17003107005016,826,795,31,0.03753,4
1813,G17003102106013,1435,824,611,0.42578,3
1098,G17003106501002,1272,802,470,0.3695,1
591,G17003105808001,1661,856,805,0.48465,1
2278,G17003107005012,1306,1273,33,0.02527,7
2018,G17003106715003,1007,984,23,0.02284,5
521,G17003100306031,1038,354,684,0.65896,28
715,G17003104313021,1091,965,126,0.11549,4
481,G17003100103003,1316,1086,230,0.17477,31
1823,G17003101003001,850,744,106,0.12471,3
134,G17003108344003,1516,1484,32,0.02111,20
1234,G17003107003013,1907,1542,365,0.1914,20
2204,G17003107402002,952,897,55,0.05777,1
1891,G17003101404004,1254,738,516,0.41148,6
1347,G17003103406001,1066,1052,14,0.01313,1
794,G17003101203001,1016,654,362,0.3563,5
2010,G17003106609003,1416,1213,203,0.14336,11
1535,G17003100404014,990,866,124,0.12525,3
2065,G17003106812001,458,458,0,0,1
932,G17003102415001,1470,1359,111,0.07551,2
84,G17003105611002,1052,874,178,0.1692,1
1634,G17003100810002,1157,906,251,0.21694,2
74,G17003104112001,1241,941,300,0.24174,2
509,G17003108339001,1190,1000,190,0.15966,4
6,G17003103102001,831,612,219,0.26354,1
2139,G17003108307004,872,603,269,0.30849,75
488,G17003100105011,1098,993,105,0.09563,14
41,G17003105609006,525,501,24,0.04571,2
516,G17003108306004,1073,577,496,0.46226,78
713,G17003101007002,750,503,247,0.32933,4
580,G17003106115001,1185,417,768,0.6481,3
769,G17003101604003,1088,706,382,0.3511,49
840,G17003102312001,986,820,166,0.16836,5
720,G17003106909003,944,944,0,0,7
247,G17003104403001,1044,1044,0,0,3
1654,G17003107709022,1682,1098,584,0.34721,4
311,G17003102518005,1569,1569,0,0,8
766,G17003101202003,1258,1138,120,0.09539,1
2317,G17003107109001,880,880,0,0,1
1155,G17003103504001,1379,1371,8,0.0058,24
663,G17003106706002,721,721,0,0,6
115,G17003105703001,1625,877,748,0.46031,7
1992,G17003100105032,691,635,56,0.08104,37
208,G17003105103004,2419,2388,31,0.01282,21
1508,G17003108380002,1943,1847,96,0.04941,3
1618,G17003105603002,1357,805,552,0.40678,4
2320,G17003107110003,697,697,0,0,4
1035,G17003106202002,1556,974,582,0.37404,6
1494,G17003104908003,833,802,31,0.03721,2
1493,G17003104905002,1368,1303,65,0.04751,49
174,G17003104304003,926,908,18,0.01944,8
1227,G17003100714002,1817,1385,432,0.23775,1
1566,G17003101406024,1133,753,380,0.33539,12
1544,G17003104914003,1370,1328,42,0.03066,3
222,G17003104314002,1228,1078,150,0.12215,42
92,G17003103006001,1515,1023,492,0.32475,2
528,G17003108306002,1854,1262,592,0.31931,32
1039,G17003102516001,1316,1139,177,0.1345,1
1255,G17003102801001,4909,4301,608,0.12385,4
1170,G17003100313004,2427,1626,801,0.33004,181
1751,G17003101703005,1285,836,449,0.34942,30
2014,G17003106702001,985,922,63,0.06396,4
1474,G17003108368001,562,542,20,0.03559,1
814,G17003102001002,1438,830,608,0.42281,6
544,G17003102521011,1787,1766,21,0.01175,2
1113,G17003104903002,987,962,25,0.02533,2
1601,G17003105305013,650,650,0,0,1
890,G17003101904012,2635,1319,1316,0.49943,5
619,G17003106009002,821,548,273,0.33252,18
562,G17003108350001,864,860,4,0.00463,2
111,G17003104911002,893,893,0,0,2
206,G17003105102002,808,778,30,0.03713,1
237,G17003108392002,1277,1042,235,0.18403,58
360,G17003104603013,755,614,141,0.18675,26
1297,G17003104109002,517,396,121,0.23404,2
1886,G17003102315002,1291,1291,0,0,7
1617,G17003105602003,1356,1283,73,0.05383,2
906,G17003100208023,2364,1008,1356,0.5736,206
945,G17003100305004,1439,1230,209,0.14524,9
1731,G17003101605011,2286,1322,964,0.4217,12
1909,G17003101506004,984,786,198,0.20122,33
668,G17003100308004,1300,907,393,0.30231,9
1277,G17003100815001,1475,1141,334,0.22644,1
1752,G17003101704001,950,579,371,0.39053,26
1521,G17003106401001,1230,792,438,0.3561,4
124,G17003103007001,2303,1346,957,0.41554,2
561,G17003108351001,1298,963,335,0.25809,9
1121,G17003103108001,1316,730,586,0.44529,1
229,G17003108401001,722,302,420,0.58172,9
1272,G17003100810005,2473,1964,509,0.20582,4
1179,G17003100621003,1311,1136,175,0.13349,7
1044,G17003108419002,3315,2675,640,0.19306,3
1861,G17003102229001,878,685,193,0.21982,2
220,G17003104313012,1578,1522,56,0.03549,37
1016,G17003103819002,694,671,23,0.03314,7
2071,G17003103007002,1326,721,605,0.45626,1
166,G17003104302001,475,452,23,0.04842,5
2269,G17003106714001,929,887,42,0.04521,1
1218,G17003108348003,856,856,0,0,2
2043,G17003100206012,3127,1363,1764,0.56412,106
1257,G17003100206011,2177,1099,1078,0.49518,137
746,G17003101604001,2484,1487,997,0.40137,36
176,G17003104305002,1333,1153,180,0.13503,72
1444,G17003100814031,3006,2475,531,0.17665,23
2309,G17003107105001,980,980,0,0,3
884,G17003108316004,1037,820,217,0.20926,1
472,G17003102804001,1366,1328,38,0.02782,5
147,G17003105802002,1692,747,945,0.55851,3
1284,G17003101105014,396,274,122,0.30808,7
1849,G17003102211003,1094,1003,91,0.08318,3
911,G17003100304001,1536,1153,383,0.24935,10
1192,G17003100620002,928,882,46,0.04957,1
916,G17003100626001,2281,1971,310,0.13591,6
716,G17003104401022,674,674,0,0,1
1436,G17003104601001,917,846,71,0.07743,20
1360,G17003101606023,1590,1176,414,0.26038,70
963,G17003100309001,374,294,80,0.2139,13
2163,G17003106910003,530,530,0,0,1
448,G17003101503007,1340,898,442,0.32985,24
1145,G17003108312003,1967,1341,626,0.31825,4
491,G17003102435002,1904,1690,214,0.11239,1
907,G17003100301041,2928,2060,868,0.29645,30
306,G17003108426002,810,466,344,0.42469,2
757,G17003100407003,781,582,199,0.2548,6
345,G17003102521023,1248,1248,0,0,2
1421,G17003100209022,1934,836,1098,0.56774,357
2041,G17003100206022,1057,446,611,0.57805,54
1173,G17003100314006,776,660,116,0.14948,39
183,G17003105805021,1275,596,679,0.53255,4
1827,G17003101004002,954,818,136,0.14256,4
711,G17003101005001,870,799,71,0.08161,1
1785,G17003101913013,1461,830,631,0.4319,3
749,G17003100403002,824,491,333,0.40413,212
2137,G17003107304001,855,835,20,0.02339,3
1088,G17003100625001,1342,1259,83,0.06185,4
772,G17003101608003,1149,809,340,0.29591,2
548,G17003106913001,1347,1339,8,0.00594,9
212,G17003108403001,583,366,217,0.37221,1
1195,G17003100632001,1012,861,151,0.14921,1
1918,G17003104005001,1329,1329,0,0,2
1534,G17003101403021,1153,588,565,0.49003,11
962,G17003100713002,1949,1807,142,0.07286,3
1434,G17003104701001,1089,1076,13,0.01194,12
1661,G17003102414003,991,910,81,0.08174,1
740,G17003101511004,1374,904,470,0.34207,46
1379,G17003100105031,1537,1002,535,0.34808,20
953,G17003102434002,370,320,50,0.13514,3
615,G17003106608004,819,653,166,0.20269,1
1185,G17003100321002,1607,1326,281,0.17486,5
144,G17003105001002,688,682,6,0.00872,5
106,G17003104208001,1163,1163,0,0,2
866,G17003101710006,1285,917,368,0.28638,14
497,G17003102514004,1389,1380,9,0.00648,1
1351,G17003101505013,1569,1184,385,0.24538,49
1046,G17003102838002,2909,2521,388,0.13338,1
1468,G17003105103002,1289,1278,11,0.00853,3
550,G17003107002003,1686,1167,519,0.30783,13
384,G17003102514002,647,637,10,0.01546,1
1076,G17003104803001,785,778,7,0.00892,3
1831,G17003102204001,1089,970,119,0.10927,4
1539,G17003100703001,2120,2024,96,0.04528,2
518,G17003100203012,1360,806,554,0.40735,76
620,G17003103807001,1216,1176,40,0.03289,48
214,G17003102715001,1286,1286,0,0,5
1541,G17003100818002,2689,2386,303,0.11268,3
1845,G17003101007001,844,653,191,0.2263,1
1114,G17003107107003,873,873,0,0,2
486,G17003100105022,2468,1613,855,0.34643,35
330,G17003105306001,1284,1284,0,0,2
1476,G17003108370001,1265,1264,1,0.00079,1
1462,G17003108439004,1035,1035,0,0,31
1069,G17003103906002,1150,957,193,0.16783,11
2187,G17003106610003,735,735,0,0,6
745,G17003101603003,1112,684,428,0.38489,17
292,G17003104408002,1028,1016,12,0.01167,1
1383,G17003102819003,2077,1130,947,0.45595,2
1273,G17003100306043,716,441,275,0.38408,15
2221,G17003107001001,2267,2113,154,0.06793,5
1933,G17003101605021,896,620,276,0.30804,14
1802,G17003100902003,1714,1454,260,0.15169,5
27,G17003104107001,1959,1520,439,0.22409,90
1496,G17003104910004,1457,1456,1,0.00069,2
1854,G17003101102002,1386,1035,351,0.25325,32
883,G17003108316002,1088,744,344,0.31618,3
2032,G17003100202002,1460,620,840,0.57534,53
1093,G17003100308003,840,728,112,0.13333,18
2022,G17003106809002,449,430,19,0.04232,1
2116,G17003100310003,1347,1060,287,0.21307,7
1502,G17003106308002,2544,1252,1292,0.50786,4
382,G17003102513004,825,823,2,0.00242,5
335,G17003106111003,1250,640,610,0.488,1
838,G17003102307002,1212,762,450,0.37129,4
805,G17003101701001,1871,1151,720,0.38482,9
1777,G17003101907023,1978,1270,708,0.35794,2
1388,G17003107608012,1838,682,1156,0.62894,163
815,G17003102001003,2202,1471,731,0.33197,42
2267,G17003100629003,1615,1513,102,0.06316,4
833,G17003108311004,3121,1879,1242,0.39795,12
295,G17003104409003,1056,1033,23,0.02178,32
1178,G17003100609002,0,0,0,,2
11,G17003104805001,1095,1019,76,0.06941,3
1573,G17003102207023,672,541,131,0.19494,3
1210,G17003107112004,1813,1813,0,0,27
882,G17003101801004,820,387,433,0.52805,5
834,G17003108311003,1968,1587,381,0.1936,3
1961,G17003101907012,1271,822,449,0.35327,1
1718,G17003101508005,601,375,226,0.37604,35
1222,G17003105305033,2068,2068,0,0,1
471,G17003102431002,532,395,137,0.25752,6
1125,G17003104205002,1078,1070,8,0.00742,8
1896,G17003107608034,1696,696,1000,0.58962,18
479,G17003100101003,2243,1794,449,0.20018,76
2213,G17003100505005,1215,1173,42,0.03457,1
284,G17003108399004,731,609,122,0.16689,5
512,G17003104909022,2017,1905,112,0.05553,9
1085,G17003105604001,1417,786,631,0.44531,11
57,G17003102924001,1229,1211,18,0.01465,3
239,G17003104401023,504,504,0,0,5
31,G17003104905001,972,932,40,0.04115,1
1584,G17003105203004,1483,1061,422,0.28456,1
1744,G17003101613001,782,504,278,0.3555,4
1592,G17003108413002,1392,809,583,0.41882,3
12,G17003102608002,1101,1101,0,0,2
1887,G17003102315003,464,464,0,0,2
2118,G17003100312002,1200,878,322,0.26833,159
324,G17003104601003,765,721,44,0.05752,65
2240,G17003100610001,1716,1513,203,0.1183,30
1964,G17003102004012,2860,2074,786,0.27483,4
424,G17003108080022,1286,717,569,0.44246,754
1437,G17003107004011,1595,1464,131,0.08213,14
408,G17003108106001,1467,1124,343,0.23381,2
1771,G17003101903004,1339,1031,308,0.23002,2
1809,G17003108311002,1364,874,490,0.35924,7
2133,G17003107302013,1136,1136,0,0,10
1479,G17003104307001,1523,1416,107,0.07026,9
1919,G17003104606001,1107,931,176,0.15899,10
918,G17003100629002,1146,1075,71,0.06195,2
1200,G17003102606002,1535,1525,10,0.00651,1
2145,G17003100321001,1593,1293,300,0.18832,11
1298,G17003103903001,1013,1013,0,0,6
1725,G17003100505002,1589,1512,77,0.04846,3
315,G17003102520002,2387,2387,0,0,3
234,G17003103018032,2399,1389,1010,0.42101,1
177,G17003104305003,960,960,0,0,11
1567,G17003101510023,1736,1117,619,0.35657,12
1841,G17003100105021,1222,885,337,0.27578,59
1598,G17003107608011,2561,1431,1130,0.44123,443
2031,G17003102426001,1291,1129,162,0.12548,1
843,G17003102312005,629,536,93,0.14785,1
1913,G17003100107024,1099,595,504,0.4586,70
346,G17003102522021,996,987,9,0.00904,1
1509,G17003108380001,918,795,123,0.13399,2
1451,G17003108374001,960,960,0,0,5
1394,G17003102212002,1734,1476,258,0.14879,4
2286,G17003100702001,2109,1828,281,0.13324,1
459,G17003108344002,1823,1724,99,0.05431,5
938,G17003103107001,1241,712,529,0.42627,29
274,G17003104408001,749,738,11,0.01469,3
1194,G17003100632005,714,641,73,0.10224,1
651,G17003108322002,1576,1291,285,0.18084,1
1878,G17003101203004,813,656,157,0.19311,12
851,G17003101407012,1131,668,463,0.40937,10
1219,G17003108348001,398,398,0,0,2
687,G17003107105002,1442,1411,31,0.0215,1
631,G17003102309002,1806,1534,272,0.15061,1
1407,G17003106503013,1405,1010,395,0.28114,1
1853,G17003101102001,1631,1109,522,0.32005,89
2199,G17003106915001,473,473,0,0,2
984,G17003105907001,1574,1071,503,0.31957,1
2070,G17003100306042,1143,828,315,0.27559,1
507,G17003108343006,1471,1471,0,0,1
1082,G17003104804005,592,592,0,0,1
2259,G17003100618001,1130,862,268,0.23717,1
2012,G17003106805002,855,813,42,0.04912,3
1955,G17003101406023,1236,623,613,0.49595,23
2234,G17003100512001,726,726,0,0,1
2101,G17003108425001,2375,2371,4,0.00168,2
2140,G17003100317001,2108,1606,502,0.23814,117
642,G17003107104004,802,802,0,0,1
1967,G17003106007002,1415,1053,362,0.25583,11
1359,G17003101605022,2064,1293,771,0.37355,38
770,G17003101607005,1089,556,533,0.48944,6
433,G17003108081002,2065,1665,400,0.1937,6
293,G17003104409001,622,622,0,0,3
1828,G17003108309001,1063,972,91,0.08561,6
543,G17003102604001,1567,1556,11,0.00702,5
1450,G17003108378001,2035,1904,131,0.06437,4
1449,G17003108430002,1434,1387,47,0.03278,1
869,G17003102403001,1402,1259,143,0.102,1
2037,G17003102434003,1106,829,277,0.25045,3
1780,G17003101904022,2703,1676,1027,0.37995,9
152,G17003105804004,442,233,209,0.47285,4
536,G17003100306011,772,509,263,0.34067,64
719,G17003106605001,1604,834,770,0.48005,8
475,G17003108342004,1307,1277,30,0.02295,3
5,G17003108387002,851,727,124,0.14571,4
1944,G17003104401013,519,495,24,0.04624,15
789,G17003100815002,1375,1170,205,0.14909,2
340,G17003102507005,1501,1384,117,0.07795,5
2000,G17003102406001,1340,1128,212,0.15821,3
661,G17003100601002,1101,1092,9,0.00817,3
2276,G17003107004021,979,790,189,0.19305,8
1321,G17003108325001,1517,1395,122,0.08042,1
1340,G17003103007003,1065,701,364,0.34178,1
2066,G17003108392001,244,244,0,0,28
1417,G17003108367001,1425,1405,20,0.01404,1
1766,G17003108316003,713,373,340,0.47686,5
1357,G17003101504023,1929,1426,503,0.26076,60
519,G17003100301031,813,557,256,0.31488,25
1834,G17003100812022,742,679,63,0.08491,1
846,G17003102315001,856,856,0,0,3
254,G17003105204004,695,401,294,0.42302,5
625,G17003100802011,1540,1185,355,0.23052,11
656,G17003108324001,2061,1902,159,0.07715,2
1292,G17003103201003,2109,1571,538,0.2551,1
1203,G17003102718001,1230,1230,0,0,5
581,G17003102831002,1146,790,356,0.31065,1
818,G17003101001004,785,638,147,0.18726,14
1613,G17003101606013,1639,1095,544,0.33191,59
2279,G17003107005011,1616,1601,15,0.00928,6
937,G17003106502002,2230,1577,653,0.29283,1
1816,G17003106706001,915,846,69,0.07541,2
1996,G17003100313005,1973,1402,571,0.28941,22
1779,G17003101911001,1162,770,392,0.33735,3
1799,G17003100901004,503,444,59,0.1173,3
215,G17003108373002,1176,1176,0,0,1
1370,G17003101105013,2148,1624,524,0.24395,7
317,G17003102520004,1541,1480,61,0.03958,3
1457,G17003104101001,776,498,278,0.35825,4
1477,G17003108373001,982,957,25,0.02546,5
1621,G17003106404002,2078,1682,396,0.19057,2
1549,G17003106305002,2074,1109,965,0.46528,3
1653,G17003107709021,1681,1171,510,0.30339,2
2238,G17003100605001,1235,918,317,0.25668,1
1328,G17003102105021,1879,1187,692,0.36828,39
1986,G17003100103004,1699,908,791,0.46557,182
133,G17003108344001,858,839,19,0.02214,17
279,G17003106009003,725,592,133,0.18345,12
2080,G17003100208013,769,377,392,0.50975,158
755,G17003100406002,882,785,97,0.10998,2
492,G17003102435001,1294,1184,110,0.08501,3
1343,G17003102420003,1401,1110,291,0.20771,10
172,G17003104304001,661,576,85,0.12859,10
2093,G17003106504001,884,534,350,0.39593,5
170,G17003104303001,1187,1187,0,0,9
2087,G17003106501003,1202,717,485,0.40349,3
55,G17003102922003,780,743,37,0.04744,1
374,G17003106116002,943,930,13,0.01379,1
1940,G17003100632006,1891,1617,274,0.1449,4
128,G17003103012001,1112,546,566,0.50899,3
353,G17003103805001,820,818,2,0.00244,1
1990,G17003100104002,858,675,183,0.21329,74
1663,G17003102416001,1263,1069,194,0.1536,4
646,G17003101909001,1864,1409,455,0.2441,6
1781,G17003101911003,1381,1064,317,0.22954,3
2149,G17003106605003,1286,715,571,0.44401,1
725,G17003100804001,2754,2720,34,0.01235,2
195,G17003103301004,2659,2254,405,0.15231,77
129,G17003108432002,1262,758,504,0.39937,27
2064,G17003106812004,601,588,13,0.02163,1
707,G17003100717001,885,718,167,0.1887,1
971,G17003100604002,1125,994,131,0.11644,1
1572,G17003102004023,1940,1331,609,0.31392,4
930,G17003102414001,1610,1340,270,0.1677,1
903,G17003100208024,1813,384,1429,0.7882,125
1972,G17003106112002,1428,920,508,0.35574,3
855,G17003101505011,1272,841,431,0.33884,26
1138,G17003107105003,694,685,9,0.01297,10
571,G17003100402022,2795,1405,1390,0.49732,144
1825,G17003101003004,1314,1112,202,0.15373,2
2144,G17003108307001,656,515,141,0.21494,21
2008,G17003106503021,1730,1074,656,0.37919,6
1368,G17003108323001,1975,1742,233,0.11797,5
622,G17003102515001,801,786,15,0.01873,1
1971,G17003106120002,944,939,5,0.0053,3
48,G17003102506001,1008,1008,0,0,1
204,G17003108342003,1272,1272,0,0,57
356,G17003103812001,644,644,0,0,36
1908,G17003101506002,687,540,147,0.21397,13
95,G17003108412001,1606,954,652,0.40598,4
1603,G17003104909013,1185,1160,25,0.0211,8
751,G17003100404021,586,487,99,0.16894,10
828,G17003101405002,1685,877,808,0.47953,8
454,G17003108436002,1393,1356,37,0.02656,16
2036,G17003102434001,1479,1206,273,0.18458,2
1529,G17003100609003,1671,1380,291,0.17415,6
1133,G17003102513003,1022,1022,0,0,3
2275,G17003107004022,1207,1101,106,0.08782,1
1612,G17003101407011,1254,759,495,0.39474,12
669,G17003100309004,761,575,186,0.24442,16
675,G17003100706001,1832,1729,103,0.05622,4
1765,G17003108316005,1311,879,432,0.32952,1
117,G17003105703003,1890,1001,889,0.47037,3
709,G17003101003005,861,786,75,0.08711,1
708,G17003108326003,2098,1862,236,0.11249,5
1737,G17003101607004,1154,848,306,0.26516,15
2173,G17003100401002,1647,1333,314,0.19065,14
1151,G17003101510012,632,463,169,0.26741,45
363,G17003104604002,1003,1002,1,0.001,21
341,G17003102508001,1153,1061,92,0.07979,9
2330,G17003104605002,470,458,12,0.02553,1
632,G17003100317004,1102,1004,98,0.08893,17
286,G17003108400002,749,652,97,0.12951,27
676,G17003100707001,2878,2607,271,0.09416,2
1376,G17003102209011,1056,962,94,0.08902,2
2160,G17003106909004,968,968,0,0,1
1949,G17003104301023,1091,1091,0,0,30
389,G17003108102002,1073,834,239,0.22274,2
767,G17003101202004,1027,794,233,0.22687,39
641,G17003108209011,2172,1243,929,0.42772,3
1557,G17003108429003,1257,1257,0,0,1
1844,G17003101006003,1085,793,292,0.26912,1
1907,G17003101506001,1250,894,356,0.2848,8
197,G17003103301002,5070,4299,771,0.15207,30
750,G17003100403003,812,534,278,0.34236,118
558,G17003108426001,1530,1312,218,0.14248,11
951,G17003101404002,1672,982,690,0.41268,6
2127,G17003106603021,1597,803,794,0.49718,1
269,G17003108424003,802,802,0,0,5
844,G17003108421006,794,730,64,0.0806,21
835,G17003102104001,2062,1274,788,0.38215,2
520,G17003100301032,1425,774,651,0.45684,83
688,G17003102105012,3288,1623,1665,0.50639,2
2063,G17003106812002,681,681,0,0,3
2089,G17003106502004,1462,1038,424,0.29001,8
1072,G17003108361001,1038,1004,34,0.03276,5
1362,G17003102209021,1303,861,442,0.33922,1
67,G17003103109002,1716,1145,571,0.33275,5
457,G17003108362001,1590,1323,267,0.16792,2
395,G17003101408001,1047,699,348,0.33238,31
2195,G17003106914002,369,369,0,0,11
761,G17003101104003,842,460,382,0.45368,14
1066,G17003103904002,1385,1330,55,0.03971,7
567,G17003100814022,1493,1341,152,0.10181,1
1763,G17003101801005,1714,1241,473,0.27596,7
658,G17003102421002,1278,1087,191,0.14945,1
955,G17003102502002,1182,1049,133,0.11252,1
1325,G17003101504014,565,394,171,0.30265,29
1686,G17003108216001,1141,1054,87,0.07625,1
1247,G17003100801006,895,834,61,0.06816,1
1132,G17003104203001,2275,1961,314,0.13802,6
2088,G17003106502001,1570,1066,504,0.32102,2
2298,G17003107102005,1894,1894,0,0,1
385,G17003102514003,1351,1321,30,0.02221,1
393,G17003100306041,1102,656,446,0.40472,4
81,G17003104909024,1113,1101,12,0.01078,3
1787,G17003102002004,1520,902,618,0.40658,1
557,G17003108397002,1518,1034,484,0.31884,6
2117,G17003100311002,777,544,233,0.29987,52
778,G17003108365001,1171,1090,81,0.06917,15
1197,G17003100633012,704,628,76,0.10795,2
1472,G17003108371001,500,463,37,0.074,4
1700,G17003108220003,1129,1117,12,0.01063,1
621,G17003104205001,1021,968,53,0.05191,10
734,G17003101103004,1443,1156,287,0.19889,33
1068,G17003103906001,826,714,112,0.13559,41
1574,G17003102207024,1144,782,362,0.31643,1
501,G17003106813002,921,859,62,0.06732,5
1637,G17003107114001,1143,1080,63,0.05512,27
1664,G17003102416002,2175,1923,252,0.11586,6
2009,G17003106503022,2418,1362,1056,0.43672,1
1319,G17003108320001,2181,1990,191,0.08757,10
2077,G17003102831001,1612,1294,318,0.19727,13
246,G17003104403005,663,663,0,0,2
159,G17003103017011,922,273,649,0.7039,7
267,G17003108424001,1070,1054,16,0.01495,12
354,G17003108360002,723,689,34,0.04703,2
1111,G17003106910004,376,376,0,0,2
1279,G17003100813004,1789,1254,535,0.29905,2
1594,G17003108402001,2589,1323,1266,0.48899,56
2129,G17003106904003,871,845,26,0.02985,2
2315,G17003107108004,941,925,16,0.017,25
380,G17003102513001,843,803,40,0.04745,1
2237,G17003100514001,1571,1421,150,0.09548,6
1948,G17003104301022,660,660,0,0,18
574,G17003106911004,1027,1015,12,0.01168,3
1526,G17003106103003,1332,808,524,0.39339,1
1241,G17003100714001,632,548,84,0.13291,7
323,G17003104503003,875,844,31,0.03543,1
1214,G17003107202003,2370,2245,125,0.05274,1
1397,G17003104202001,1707,1608,99,0.058,14
2171,G17003107306001,780,780,0,0,1
1038,G17003102515003,904,904,0,0,1
200,G17003104308001,965,954,11,0.0114,4
275,G17003105302001,839,839,0,0,9
948,G17003108316006,1018,839,179,0.17583,4
990,G17003104503004,646,616,30,0.04644,4
1994,G17003100205001,2561,1308,1253,0.48926,352
726,G17003108383001,916,726,190,0.20742,14
2016,G17003106704001,1858,1794,64,0.03445,3
1097,G17003102227001,1131,868,263,0.23254,3
1,G17003102909001,792,792,0,0,3
666,G17003100307031,756,652,104,0.13757,27
1943,G17003108415002,1215,1215,0,0,6
1261,G17003101913012,1500,898,602,0.40133,13
1352,G17003103814001,1746,1746,0,0,10
1144,G17003101504022,1196,929,267,0.22324,15
1260,G17003102924002,895,895,0,0,1
1797,G17003100819001,1152,1029,123,0.10677,11
682,G17003102306003,813,553,260,0.3198,2
372,G17003106115002,1793,1036,757,0.4222,1
1822,G17003101002007,581,517,64,0.11015,5
1580,G17003101005004,1102,1050,52,0.04719,9
1363,G17003102209022,2022,1313,709,0.35064,1
49,G17003102506002,1007,986,21,0.02085,1
1058,G17003106302001,2217,1087,1130,0.5097,2
1950,G17003104301021,1663,1387,276,0.16597,19
199,G17003104306002,1037,1027,10,0.00964,5
2094,G17003106504002,956,618,338,0.35356,8
671,G17003100311003,1415,1028,387,0.2735,2
2046,G17003102503004,549,495,54,0.09836,3
327,G17003105305011,1688,1688,0,0,1
469,G17003102429002,565,433,132,0.23363,13
905,G17003100208011,1470,918,552,0.37551,264
245,G17003104403004,703,703,0,0,25
259,G17003108397003,2018,1504,514,0.25471,18
1015,G17003103819001,599,595,4,0.00668,5
573,G17003106711001,1486,1451,35,0.02355,4
2029,G17003102425001,2096,1831,265,0.12643,5
864,G17003101710003,998,544,454,0.45491,8
291,G17003108364002,1419,1351,68,0.04792,8
2002,G17003102305002,1165,704,461,0.39571,1
61,G17003102925004,246,246,0,0,1
797,G17003101203005,552,464,88,0.15942,13
901,G17003102429001,1253,989,264,0.21069,8
2290,G17003106720001,1787,1787,0,0,1
2081,G17003100208012,943,866,77,0.08165,108
2192,G17003106912003,870,870,0,0,1
1206,G17003102827002,1007,852,155,0.15392,144
1562,G17003108416001,817,817,0,0,3
1249,G17003100802021,534,338,196,0.36704,20
2258,G17003100615001,1859,1685,174,0.0936,1
753,G17003100404023,1168,920,248,0.21233,18
1894,G17003101407023,1528,891,637,0.41688,9
1883,G17003108318004,1312,787,525,0.40015,69
1177,G17003100402011,1022,780,242,0.23679,47
1466,G17003104610001,2034,1838,196,0.09636,9
2042,G17003100206023,926,442,484,0.52268,64
989,G17003102213003,581,514,67,0.11532,2
1326,G17003101505022,1167,918,249,0.21337,11
972,G17003100404012,485,437,48,0.09897,3
490,G17003100106004,1490,1152,338,0.22685,49
808,G17003101703001,741,370,371,0.50067,1
798,G17003101203006,826,543,283,0.34262,28
874,G17003102504002,984,946,38,0.03862,2
9,G17003104804006,731,623,108,0.14774,1
411,G17003108107011,1500,1029,471,0.314,3
832,G17003108311001,1190,561,629,0.52857,7
1324,G17003101606012,919,523,396,0.4309,8
88,G17003102601001,1047,1040,7,0.00669,1
1161,G17003106720003,1234,1234,0,0,3
1774,G17003100301013,1143,723,420,0.36745,56
1888,G17003101402001,2318,1448,870,0.37532,47
383,G17003102513005,1127,1118,9,0.00799,6
1119,G17003105806004,2339,1508,831,0.35528,4
1801,G17003100902002,1202,1087,115,0.09567,8
453,G17003108360003,1090,1078,12,0.01101,12
1548,G17003106305001,2051,999,1052,0.51292,10
1074,G17003104801001,917,917,0,0,5
887,G17003101903001,1176,453,723,0.6148,9
802,G17003101612002,1558,955,603,0.38703,11
1513,G17003106403006,995,938,57,0.05729,14
1080,G17003104804003,1378,1330,48,0.03483,22
2125,G17003108350005,972,790,182,0.18724,30
1420,G17003108382002,677,559,118,0.1743,10
455,G17003108358001,1469,1433,36,0.02451,19
2263,G17003100624001,1622,1556,66,0.04069,1
2306,G17003108347002,670,670,0,0,1
1087,G17003100206013,1393,764,629,0.45154,184
630,G17003102426002,1737,1534,203,0.11687,6
2182,G17003106608003,1516,1025,491,0.32388,19
209,G17003108404002,1954,1164,790,0.4043,15
1727,G17003101602001,605,447,158,0.26116,20
606,G17003108321001,1652,1225,427,0.25847,42
850,G17003102107002,1345,914,431,0.32045,1
856,G17003101505012,902,608,294,0.32594,9
756,G17003100407002,854,669,185,0.21663,7
151,G17003105804003,1163,658,505,0.43422,6
921,G17003102211002,1713,1442,271,0.1582,4
2241,G17003100612001,2235,2126,109,0.04877,1
270,G17003104406001,660,648,12,0.01818,2
1269,G17003107305004,1546,1546,0,0,1
2055,G17003106501001,1247,544,703,0.56375,5
101,G17003104206002,858,853,5,0.00583,12
339,G17003102507004,1403,1383,20,0.01426,2
1465,G17003104805003,1054,957,97,0.09203,6
1348,G17003103514001,1551,1548,3,0.00193,39
2156,G17003106607001,1355,1270,85,0.06273,3
1879,G17003101204001,1050,835,215,0.20476,1
1732,G17003101605023,1608,859,749,0.4658,11
213,G17003102714001,1151,1140,11,0.00956,2
1640,G17003107201003,1159,1098,61,0.05263,2
1403,G17003104313023,1664,1646,18,0.01082,38
1864,G17003101104002,1694,946,748,0.44156,13
1945,G17003104313011,322,307,15,0.04658,8
969,G17003102215002,1581,1219,362,0.22897,1
230,G17003106004001,1748,732,1016,0.58124,1
1578,G17003101006004,1634,1267,367,0.2246,33
785,G17003100514002,603,539,64,0.10614,5
1920,G17003104909023,664,617,47,0.07078,5
1071,G17003108361003,790,781,9,0.01139,126
2050,G17003106407002,698,512,186,0.26648,1
93,G17003103006002,1883,994,889,0.47212,3
774,G17003101610002,888,842,46,0.0518,2
1335,G17003103511001,1649,1639,10,0.00606,5
714,G17003104607002,990,519,471,0.47576,12
523,G17003100307011,1734,1291,443,0.25548,52
1742,G17003101609002,925,778,147,0.15892,20
1871,G17003102307003,1436,1219,217,0.15111,2
1829,G17003108309003,919,782,137,0.14908,2
1984,G17003108359003,1120,1120,0,0,6
526,G17003100107012,1841,1318,523,0.28408,406
1914,G17003102502001,1786,1576,210,0.11758,7
1293,G17003108390003,1159,739,420,0.36238,1
1425,G17003103011001,1310,725,585,0.44656,10
1473,G17003108370002,1192,1140,52,0.04362,1
178,G17003105001004,1249,1249,0,0,1
1926,G17003100105013,1064,757,307,0.28853,208
812,G17003101912002,1059,491,568,0.53636,4
1768,G17003101902003,1511,735,776,0.51357,2
980,G17003106604003,959,483,476,0.49635,2
33,G17003105607001,1315,932,383,0.29125,3
1003,G17003108439003,947,847,100,0.1056,53
633,G17003100627001,782,711,71,0.09079,2
1188,G17003100619011,623,579,44,0.07063,1
900,G17003102427001,1689,1477,212,0.12552,7
1927,G17003100209012,683,435,248,0.3631,235
1489,G17003100401001,1328,1006,322,0.24247,407
1987,G17003100201002,1445,1048,397,0.27474,387
763,G17003101201001,1452,1380,72,0.04959,1
2115,G17003100310002,996,879,117,0.11747,12
1117,G17003106309001,2174,980,1194,0.54922,7
10,G17003104804007,906,906,0,0,1
2167,G17003107304002,1388,1377,11,0.00793,1
146,G17003105802001,1690,1092,598,0.35385,6
752,G17003100404025,1551,1308,243,0.15667,3
98,G17003108413003,992,694,298,0.3004,14
193,G17003108368002,1699,1694,5,0.00294,39
2059,G17003106811001,810,810,0,0,2
2049,G17003106407001,872,566,306,0.35092,1
2021,G17003106719001,1313,1275,38,0.02894,7
853,G17003101504021,570,385,185,0.32456,12
243,G17003104402012,1716,1684,32,0.01865,14
2164,G17003106911001,553,542,11,0.01989,4
1911,G17003101505021,1418,924,494,0.34838,14
672,G17003100312003,1055,821,234,0.2218,33
1736,G17003101607001,857,595,262,0.30572,31
1366,G17003108325002,2257,2088,169,0.07488,2
145,G17003105001003,648,648,0,0,10
1715,G17003101507002,1413,897,516,0.36518,39
104,G17003104207004,1007,986,21,0.02085,3
1081,G17003104804004,1251,1213,38,0.03038,1
163,G17003103018021,820,533,287,0.35,1
1858,G17003102214003,1201,841,360,0.29975,4
1134,G17003104004002,584,584,0,0,1
533,G17003103515002,415,230,185,0.44578,7
1175,G17003100321003,1544,1327,217,0.14054,7
1555,G17003108351003,1530,975,555,0.36275,1
1153,G17003100611001,1309,1272,37,0.02827,1
1317,G17003100203023,2517,1576,941,0.37386,195
337,G17003102507002,1005,1005,0,0,3
727,G17003100812012,1899,1727,172,0.09057,1
886,G17003101902001,1424,825,599,0.42065,13
1527,G17003100207024,912,755,157,0.17215,154
297,G17003108343004,771,771,0,0,1
689,G17003102309001,1755,1519,236,0.13447,7
893,G17003102108001,1028,770,258,0.25097,1
1804,G17003100902005,544,531,13,0.0239,1
473,G17003102432002,962,767,195,0.2027,4
819,G17003101001001,846,602,244,0.28842,34
2217,G17003106701001,760,760,0,0,2
1723,G17003101512002,1594,721,873,0.54768,9
813,G17003108315002,1454,884,570,0.39202,1
2184,G17003106609002,1138,1108,30,0.02636,6
2186,G17003106610002,1137,1117,20,0.01759,4
970,G17003101607002,1212,811,401,0.33086,7
2096,G17003106504004,2631,1424,1207,0.45876,3
1759,G17003101710004,1129,750,379,0.3357,2
1903,G17003101503002,1255,848,407,0.3243,138
1632,G17003100804002,659,614,45,0.06829,22
1285,G17003101403011,1080,291,789,0.73056,8
1747,G17003100811003,1124,927,197,0.17527,1
806,G17003101702001,1488,1013,475,0.31922,29
1201,G17003102607002,1246,1151,95,0.07624,7
590,G17003106009004,1185,739,446,0.37637,23
579,G17003104109001,796,694,102,0.12814,8
1734,G17003101606022,1083,725,358,0.33056,12
1628,G17003108411003,1911,781,1130,0.59131,5
946,G17003102608001,1393,1388,5,0.00359,1
123,G17003105801002,1402,729,673,0.48003,6
1463,G17003100102021,1427,1019,408,0.28591,126
1414,G17003101906022,1912,1335,577,0.30178,3
885,G17003101901001,2720,1487,1233,0.45331,9
1917,G17003103404001,1740,594,1146,0.65862,2
2155,G17003106606005,1525,1059,466,0.30557,6
880,G17003100206021,1003,529,474,0.47258,59
800,G17003101204003,1552,1062,490,0.31572,45
1530,G17003100404024,515,326,189,0.36699,9
1865,G17003101105015,433,393,40,0.09238,24
915,G17003108319001,1503,1365,138,0.09182,2
1141,G17003106910002,950,950,0,0,19
2079,G17003100208021,1480,706,774,0.52297,334
547,G17003102603001,1483,1483,0,0,1
1989,G17003100103001,998,694,304,0.30461,58
997,G17003102312002,1644,1591,53,0.03224,1
1892,G17003101405003,1252,757,495,0.39537,18
1699,G17003108220002,504,492,12,0.02381,1
556,G17003108399002,1028,878,150,0.14591,3
1123,G17003106203001,888,638,250,0.28153,3
2114,G17003100310001,1179,839,340,0.28838,64
566,G17003106406002,1264,867,397,0.31408,2
695,G17003100317003,1566,1415,151,0.09642,18
2078,G17003100207021,2372,1255,1117,0.47091,234
737,G17003101507003,937,619,318,0.33938,20
782,G17003100506002,1145,1020,125,0.10917,1
287,G17003102808001,850,815,35,0.04118,6
1792,G17003101408003,1241,1028,213,0.17164,20
1630,G17003108395001,1379,1301,78,0.05656,13
1607,G17003104401012,913,906,7,0.00767,33
2181,G17003100408002,831,741,90,0.1083,4
181,G17003105003001,695,568,127,0.18273,1
1830,G17003108309002,886,838,48,0.05418,6
1412,G17003108317001,2313,1489,824,0.35625,19
1137,G17003101908005,1538,1286,252,0.16385,2
1516,G17003106405002,1482,1253,229,0.15452,3
298,G17003108343005,1314,1302,12,0.00913,1
690,G17003102424002,1805,779,1026,0.56842,5
112,G17003104911003,908,908,0,0,7
1211,G17003107109002,1611,1590,21,0.01304,14
1460,G17003104301011,859,859,0,0,25
1484,G17003105305021,1495,1495,0,0,5
2098,G17003106814001,421,421,0,0,1
1491,G17003104906001,1452,1405,47,0.03237,7
954,G17003108423002,2133,1972,161,0.07548,4
600,G17003100609005,767,581,186,0.2425,14
889,G17003101904021,1939,1315,624,0.32182,15
435,G17003108121005,606,539,67,0.11056,1
589,G17003106203006,1831,1238,593,0.32387,1
1941,G17003108371002,1439,1401,38,0.02641,19
52,G17003108414001,722,712,10,0.01385,2
366,G17003104605001,320,320,0,0,1
2027,G17003102422002,1813,1594,219,0.12079,1
2322,G17003107111001,1486,1446,40,0.02692,10
2045,G17003102503002,968,903,65,0.06715,5
1798,G17003100901001,1040,803,237,0.22788,5
1382,G17003102519004,2725,2661,64,0.02349,3
1537,G17003100502002,2121,1879,242,0.1141,61
1993,G17003100107021,1499,905,594,0.39626,80
736,G17003101506003,947,736,211,0.22281,10
1505,G17003106308001,1995,967,1028,0.51529,2
637,G17003100715006,714,670,44,0.06162,1
416,G17003108111004,1172,876,296,0.25256,1
758,G17003100408001,984,842,142,0.14431,1
1658,G17003102412001,1178,949,229,0.1944,5
427,G17003108121001,1149,1063,86,0.07485,1
2207,G17003108308003,1171,1048,123,0.10504,3
377,G17003102512002,948,948,0,0,5
1517,G17003106406001,1234,780,454,0.36791,5
24,G17003104105001,1257,1022,235,0.18695,18
1639,G17003107115002,1472,1472,0,0,4
1235,G17003100810003,946,702,244,0.25793,1
728,G17003101007005,987,548,439,0.44478,4
456,G17003108345001,1563,1506,57,0.03647,6
1873,G17003102308001,1195,914,281,0.23515,1
1893,G17003101407024,1409,752,657,0.46629,11
2074,G17003107203002,889,866,23,0.02587,1
1052,G17003106203005,1022,704,318,0.31115,11
2232,G17003107501004,1567,1552,15,0.00957,3
216,G17003108411001,1905,569,1336,0.70131,3
1755,G17003101705001,1643,1142,501,0.30493,12
809,G17003101704002,1170,618,552,0.47179,4
8,G17003104005002,1093,1075,18,0.01647,1
483,G17003100107011,2105,1288,817,0.38812,646
1869,G17003102306001,722,448,274,0.3795,1
1815,G17003108351004,1578,901,677,0.42902,2
881,G17003100207022,3078,1743,1335,0.43372,87
1956,G17003100101002,1525,1346,179,0.11738,45
542,G17003102518003,898,898,0,0,4
1270,G17003103018023,996,384,612,0.61446,8
1341,G17003103009003,1050,553,497,0.47333,1
1525,G17003108314002,2278,2009,269,0.11809,9
1738,G17003101608001,1065,464,601,0.56432,3
1753,G17003101704003,919,675,244,0.26551,7
1342,G17003102105023,1066,624,442,0.41463,1
1860,G17003102225001,1424,1066,358,0.2514,2
1128,G17003101708002,1159,790,369,0.31838,11
28,G17003104108001,1258,912,346,0.27504,3
313,G17003102518002,981,981,0,0,14
1002,G17003101703003,846,644,202,0.23877,7
2053,G17003106408001,1024,761,263,0.25684,10
30,G17003104903001,1303,1098,205,0.15733,8
1778,G17003101908002,808,693,115,0.14233,3
1312,G17003107506004,629,629,0,0,1
1591,G17003108435001,8881,7963,918,0.10337,6
585,G17003100609001,756,622,134,0.17725,14
1862,G17003102303001,1170,765,405,0.34615,2
1764,G17003108316001,1755,1134,621,0.35385,3
122,G17003105801001,1594,886,708,0.44417,2
1942,G17003108331002,1534,1383,151,0.09844,36
762,G17003101105012,606,438,168,0.27723,11
531,G17003100203011,1619,1016,603,0.37245,20
1581,G17003101005005,1897,1376,521,0.27464,669
628,G17003101510021,1117,727,390,0.34915,25
1867,G17003101105011,1053,921,132,0.12536,36
545,G17003102605001,1837,1826,11,0.00599,1
487,G17003100105012,1669,1285,384,0.23008,33
1767,G17003101902002,1726,1078,648,0.37543,1
1510,G17003108331001,3211,2902,309,0.09623,1
1730,G17003101603002,1031,427,604,0.58584,12
2280,G17003107005013,1932,1892,40,0.0207,10
831,G17003102101003,937,758,179,0.19104,25
1983,G17003108359002,983,976,7,0.00712,9
2176,G17003100404011,698,578,120,0.17192,10
155,G17003102606001,1057,1057,0,0,1
587,G17003100204002,1693,1178,515,0.30419,186
1327,G17003102105011,1281,653,628,0.49024,1
2086,G17003100303002,1599,1023,576,0.36023,128
842,G17003102312004,1393,1331,62,0.04451,2
1282,G17003101003002,1061,692,369,0.34779,13
961,G17003102410001,907,786,121,0.13341,14
2214,G17003100508001,1427,1327,100,0.07008,2
97,G17003108413004,698,488,210,0.30086,1
1843,G17003101006002,1445,985,460,0.31834,169
351,G17003102827001,1395,1194,201,0.14409,3
1142,G17003108363002,860,800,60,0.06977,5
1805,G17003100903001,1325,1178,147,0.11094,18
1615,G17003101510011,1906,1193,713,0.37408,18
2095,G17003106504003,1283,771,512,0.39906,1
922,G17003102213002,787,661,126,0.1601,2
369,G17003106113003,1069,530,539,0.50421,3
1008,G17003101407022,1463,929,534,0.365,18
1413,G17003101510022,1251,667,584,0.46683,9
826,G17003101404001,1432,818,614,0.42877,23
1642,G17003106904001,830,811,19,0.02289,13
1652,G17003107709012,1233,758,475,0.38524,3
2197,G17003106914005,585,576,9,0.01538,2
464,G17003104602002,1582,1414,168,0.10619,8
1353,G17003103907001,1276,980,296,0.23197,13
1745,G17003101613002,1081,465,616,0.56984,6
2289,G17003100711001,1503,1359,144,0.09581,2
1169,G17003100312001,1242,946,296,0.23833,36
1565,G17003101403022,1517,938,579,0.38167,21
1075,G17003104802001,657,657,0,0,2
1852,G17003101101005,1336,1174,162,0.12126,12
1323,G17003101406011,2969,1147,1822,0.61367,53
1960,G17003101913011,2980,2031,949,0.31846,2
552,G17003107004023,1654,1576,78,0.04716,10
219,G17003104313022,646,624,22,0.03406,16
2235,G17003100513001,1553,1396,157,0.10109,5
273,G17003104407002,798,785,13,0.01629,3
1461,G17003104301012,886,853,33,0.03725,8
450,G17003101302001,1598,1105,493,0.30851,190
192,G17003108428004,1431,734,697,0.48707,1
1851,G17003101101002,1334,1128,206,0.15442,18
271,G17003104406002,1396,1373,23,0.01648,1
1716,G17003101507004,1180,836,344,0.29153,14
1459,G17003104109003,1610,1400,210,0.13043,17
607,G17003108436001,1216,1120,96,0.07895,16
235,G17003103403001,1734,781,953,0.5496,1
2292,G17003106720004,424,415,9,0.02123,4
1610,G17003101303003,1684,1086,598,0.35511,338
1560,G17003108387001,2235,2235,0,0,6
29,G17003104108002,1943,1561,382,0.1966,4
1182,G17003100315011,844,555,289,0.34242,10
1977,G17003108365002,477,451,26,0.05451,24
830,G17003102101002,1129,748,381,0.33747,11
1041,G17003102516003,1584,1521,63,0.03977,2
999,G17003106112001,912,450,462,0.50658,2
904,G17003100208014,1330,710,620,0.46617,197
2128,G17003106904002,911,893,18,0.01976,2
171,G17003104303003,474,474,0,0,5
1126,G17003104802002,500,495,5,0.01,1
1579,G17003101004003,1250,1131,119,0.0952,4
1278,G17003100813006,755,694,61,0.08079,1
1975,G17003106121001,1068,1022,46,0.04307,12
858,G17003101707001,963,635,328,0.3406,3
54,G17003102922002,1316,1306,10,0.0076,1
1445,G17003108104003,2491,1789,702,0.28181,5
993,G17003104102001,1248,852,396,0.31731,11
2307,G17003106805001,430,430,0,0,5
2159,G17003106608002,1510,1375,135,0.0894,9
525,G17003100106001,2724,1835,889,0.32636,106
1636,G17003107113002,832,813,19,0.02284,2
1724,G17003101512003,934,569,365,0.39079,5
810,G17003101705002,787,475,312,0.39644,2
1668,G17003108257001,984,758,226,0.22967,1
857,G17003101706002,1761,1159,602,0.34185,11
1205,G17003102713001,1169,1165,4,0.00342,3
36,G17003105608004,828,650,178,0.21498,1
1559,G17003108412002,1918,1065,853,0.44473,3
1890,G17003101402003,2271,1166,1105,0.48657,10
451,G17003101606011,1441,763,678,0.47051,5
1268,G17003107306002,1037,1033,4,0.00386,4
1743,G17003101612001,1106,732,374,0.33816,10
1336,G17003108392003,670,508,162,0.24179,4
23,G17003108363001,723,635,88,0.12172,21
960,G17003100512002,836,760,76,0.09091,6
929,G17003102413001,1878,1729,149,0.07934,6
1172,G17003100608002,0,0,0,,1
2083,G17003100209011,2245,1023,1222,0.54432,362
1586,G17003105301002,684,551,133,0.19444,1
290,G17003108364001,767,744,23,0.02999,4
793,G17003100901003,622,460,162,0.26045,3
1356,G17003100802022,906,780,126,0.13907,3
2052,G17003106407004,807,553,254,0.31475,3
2222,G17003107002001,1814,1199,615,0.33903,1
86,G17003105611004,1268,929,339,0.26735,3
2239,G17003108321002,741,704,37,0.04993,2
1404,G17003102522025,873,873,0,0,3
1904,G17003101503005,788,678,110,0.13959,25
1583,G17003105201001,2278,1545,733,0.32177,7
495,G17003102510001,1284,1237,47,0.0366,1
2321,G17003107110001,1215,1198,17,0.01399,2
1719,G17003101510024,581,476,105,0.18072,1
1593,G17003108305003,1262,583,679,0.53803,2
2198,G17003106915003,643,622,21,0.03266,2
1307,G17003102206012,916,811,105,0.11463,1
2273,G17003106716003,386,324,62,0.16062,1
1390,G17003107608031,2126,854,1272,0.59831,66
1970,G17003106110001,1188,971,217,0.18266,4
1077,G17003104803002,407,402,5,0.01229,3
482,G17003100107023,1184,745,439,0.37078,50
1086,G17003102002003,883,620,263,0.29785,1
1931,G17003107302022,1447,1418,29,0.02004,2
924,G17003102216001,1319,1244,75,0.05686,10
731,G17003101101004,1000,837,163,0.163,11
1756,G17003101706001,1013,741,272,0.26851,1
1866,G17003101105021,1418,804,614,0.433,52
1558,G17003108429001,413,392,21,0.05085,4
645,G17003101908003,1637,974,663,0.40501,2
597,G17003101406021,1152,587,565,0.49045,1
2175,G17003100402013,1350,966,384,0.28444,15
2039,G17003100203022,1121,556,565,0.50401,136
87,G17003105701001,1296,740,556,0.42901,1
169,G17003104302005,1682,1682,0,0,18
1515,G17003106404001,1575,1434,141,0.08952,4
344,G17003102511002,741,726,15,0.02024,5
1988,G17003100102011,1716,1051,665,0.38753,416
824,G17003108318002,1136,806,330,0.29049,38
2190,G17003106611001,1309,1232,77,0.05882,7
776,G17003102504004,1113,978,135,0.12129,2
2152,G17003106606002,842,842,0,0,1
1193,G17003100632003,911,570,341,0.37431,7
1305,G17003103204001,2523,2034,489,0.19382,5
1616,G17003101607003,1696,1278,418,0.24646,38
902,G17003100207012,1075,703,372,0.34605,115
873,G17003102503003,1299,1239,60,0.04619,3
634,G17003100321005,954,568,386,0.40461,38
121,G17003105705002,1373,769,604,0.43991,11
944,G17003100305001,1407,1100,307,0.21819,16
1334,G17003102209012,899,633,266,0.29588,1
1036,G17003106203003,1124,802,322,0.28648,1
1760,G17003101711003,1215,843,372,0.30617,24
2001,G17003102407001,1427,1081,346,0.24247,5
35,G17003105608002,1195,946,249,0.20837,1
602,G17003100633024,970,753,217,0.22371,1
1609,G17003101301003,1807,1326,481,0.26619,44
1722,G17003101511003,983,379,604,0.61445,9
1315,G17003100209021,2261,1366,895,0.39584,1940
1455,G17003103501001,743,441,302,0.40646,34
1037,G17003102515002,860,860,0,0,1
375,G17003106117001,510,426,84,0.16471,2
1395,G17003104004001,1077,1077,0,0,24
1540,G17003108422001,2344,2073,271,0.11561,18
1212,G17003107110002,1533,1502,31,0.02022,2
1608,G17003101502004,1589,1406,183,0.11517,94
527,G17003108306003,962,500,462,0.48025,198
773,G17003101610001,838,680,158,0.18854,34
1503,G17003106308003,1426,879,547,0.38359,3
1570,G17003101906021,1832,1141,691,0.37718,2
2142,G17003100319001,1211,1130,81,0.06689,4
308,G17003106103002,2141,1329,812,0.37926,15
1456,G17003103510002,817,809,8,0.00979,49
1482,G17003104401024,745,745,0,0,13
1208,G17003107103001,1365,1258,107,0.07839,15
1991,G17003100104001,1632,1376,256,0.15686,77
63,G17003103106001,1975,1430,545,0.27595,7
260,G17003108397001,1258,897,361,0.28696,6
1589,G17003105302004,1177,1145,32,0.02719,12
1900,G17003101502005,1761,1283,478,0.27144,39
118,G17003105704001,1053,692,361,0.34283,4
272,G17003104407001,703,695,8,0.01138,4
223,G17003104314003,1742,1714,28,0.01607,51
231,G17003106004002,1053,579,474,0.45014,5
1424,G17003109801001,0,0,0,,2
2281,G17003107504003,746,746,0,0,1
1791,G17003101303004,1997,933,1064,0.5328,227
1538,G17003100502003,1863,1543,320,0.17177,22
1331,G17003102212001,1331,1149,182,0.13674,3
263,G17003108420002,2059,1500,559,0.27149,4
2054,G17003106408002,748,551,197,0.26337,14
120,G17003105705001,1181,567,614,0.5199,1
664,G17003104212002,758,717,41,0.05409,24
1495,G17003104909021,1031,1031,0,0,3
1167,G17003102402001,1469,1306,163,0.11096,2
1848,G17003102210002,1689,1144,545,0.32268,3
807,G17003101702002,1359,973,386,0.28403,29
1929,G17003100307021,849,477,372,0.43816,1
2056,G17003106810002,576,576,0,0,2
399,G17003108103014,737,540,197,0.2673,2
2135,G17003107302014,2036,2036,0,0,5
852,G17003101504012,1582,1287,295,0.18647,32
1143,G17003102511003,1694,1595,99,0.05844,2
1545,G17003104914002,807,807,0,0,1
1174,G17003100315022,1112,649,463,0.41637,24
2203,G17003107402001,1954,1903,51,0.0261,3
268,G17003108424002,1502,1502,0,0,5
549,G17003107001002,1219,1017,202,0.16571,2
1092,G17003100309002,1017,699,318,0.31268,33
2162,G17003106910001,847,733,114,0.13459,2
1614,G17003101502001,1169,820,349,0.29855,41
1369,G17003108383002,590,538,52,0.08814,3
1627,G17003108410001,683,551,132,0.19327,93
1490,G17003100305003,1429,1115,314,0.21973,19
1746,G17003101702003,1519,819,700,0.46083,8
2324,G17003107111003,699,690,9,0.01288,2
1519,G17003106308004,1491,890,601,0.40309,1
1419,G17003108366001,1299,1209,90,0.06928,5
2082,G17003100209013,2085,982,1103,0.52902,264
957,G17003108421003,580,580,0,0,1
1162,G17003105608003,959,880,79,0.08238,2
265,G17003103510003,2194,1281,913,0.41613,94
996,G17003100602002,1234,1007,227,0.18395,4
379,G17003102512001,717,717,0,0,10
1105,G17003100403001,1020,664,356,0.34902,150
168,G17003104302004,1164,1144,20,0.01718,7
910,G17003100302004,1845,1378,467,0.25312,123
238,G17003104401011,1283,1283,0,0,8
1396,G17003104201001,1224,1122,102,0.08333,107
1936,G17003100301011,993,521,472,0.47533,31
2185,G17003106610001,821,813,8,0.00974,6
765,G17003101202002,666,589,77,0.11562,11
1399,G17003108418002,2037,2014,23,0.01129,21
1299,G17003103511002,7,7,0,0,2
2233,G17003100510001,1610,1326,284,0.1764,1
2130,G17003106904004,969,969,0,0,2
733,G17003101103003,946,646,300,0.31712,6
825,G17003101401002,2144,1122,1022,0.47668,149
1793,G17003101605012,2212,1106,1106,0.5,16
1898,G17003101408004,1235,559,676,0.54737,39
1835,G17003101403012,1668,762,906,0.54317,11
555,G17003108352001,1871,1093,778,0.41582,8
2248,G17003107003021,1217,940,277,0.22761,1
2220,G17003106703002,870,840,30,0.03448,6
135,G17003108439002,356,344,12,0.03371,1
1821,G17003101002006,1109,921,188,0.16952,5
2216,G17003106611004,1249,837,412,0.32986,1
1031,G17003106120001,642,603,39,0.06075,11
2196,G17003106914004,884,884,0,0,1
1033,G17003106201003,1580,932,648,0.41013,1
1019,G17003103903002,1896,1851,45,0.02373,19
1811,G17003102106011,645,238,407,0.63101,6
1304,G17003106006002,766,335,431,0.56266,10
2132,G17003107302023,885,873,12,0.01356,1
66,G17003103109001,1516,904,612,0.40369,3
827,G17003101405001,1184,605,579,0.48902,12
1400,G17003104309002,423,423,0,0,12
2005,G17003102409001,1236,949,287,0.2322,23
640,G17003100627002,835,820,15,0.01796,7
1954,G17003101403023,1802,1280,522,0.28968,30
1899,G17003101408005,2956,1797,1159,0.39208,28
1104,G17003107108005,576,576,0,0,1
1556,G17003108079003,1181,836,345,0.29213,2
738,G17003101508001,992,483,509,0.5131,37
1997,G17003103907003,3400,2313,1087,0.31971,2
817,G17003101001003,940,816,124,0.13191,4
505,G17003106905001,952,947,5,0.00525,2
34,G17003105608001,1823,1340,483,0.26495,1
2158,G17003106608001,714,714,0,0,6
1469,G17003104801002,1128,1109,19,0.01684,9
321,G17003103802001,194,194,0,0,3
684,G17003104607001,1522,1432,90,0.05913,3
1337,G17003103501002,1246,838,408,0.32745,9
18,G17003108433001,1772,1321,451,0.25451,16
848,G17003103902002,638,595,43,0.0674,22
2108,G17003107301001,717,717,0,0,3
594,G17003100301042,760,362,398,0.52368,28
927,G17003102423002,1583,1330,253,0.15982,3
1656,G17003102408002,781,693,88,0.11268,2
2296,G17003107102003,1271,1271,0,0,3
466,G17003106603024,1262,838,424,0.33597,4
582,G17003108312002,2204,1068,1136,0.51543,1
1826,G17003101004001,823,805,18,0.02187,1
102,G17003104207001,598,507,91,0.15217,4
1784,G17003101911005,2210,1263,947,0.42851,4
1998,G17003102204002,1476,1228,248,0.16802,2
1554,G17003106305004,1106,583,523,0.47288,13
1014,G17003103818002,314,309,5,0.01592,6
796,G17003101203003,1633,1477,156,0.09553,4
1498,G17003104910005,1986,1986,0,0,3
2,G17003102909002,924,899,25,0.02706,1
72,G17003104111001,1070,862,208,0.19439,2
1877,G17003101202001,1601,1104,497,0.31043,3
1281,G17003100814011,1031,769,262,0.25412,2
1772,G17003100107022,1492,855,637,0.42694,29
696,G17003100318001,1717,1249,468,0.27257,6
1782,G17003101911004,1462,1040,422,0.28865,3
627,G17003101503003,1222,1074,148,0.12111,16
1531,G17003100404022,881,858,23,0.02611,23
1023,G17003104605005,644,644,0,0,1
1140,G17003106119002,776,762,14,0.01804,2
1754,G17003101704004,681,415,266,0.3906,5
1840,G17003101005003,512,433,79,0.1543,1
1571,G17003102004022,1268,953,315,0.24842,2
2212,G17003108437001,1049,971,78,0.07436,1
741,G17003101512001,1152,640,512,0.44444,6
1758,G17003101710001,1906,1458,448,0.23505,8
1428,G17003103012002,544,440,104,0.19118,1
1985,G17003108359001,1492,1485,7,0.00469,106
361,G17003104603011,1224,1074,150,0.12255,13
1386,G17003102519003,1153,1153,0,0,3
1924,G17003107107002,536,525,11,0.02052,3
73,G17003104111002,1176,864,312,0.26531,2
182,G17003105101001,1685,1164,521,0.3092,13
40,G17003105609005,874,666,208,0.23799,1
355,G17003108360001,850,843,7,0.00824,2
1748,G17003100207011,818,477,341,0.41687,54
261,G17003108305001,1360,876,484,0.35588,1
2068,G17003102207021,1800,1345,455,0.25278,9
868,G17003108423001,1366,1184,182,0.13324,17
965,G17003100704001,1353,1084,269,0.19882,1
332,G17003105306003,876,817,59,0.06735,4
730,G17003101101003,448,376,72,0.16071,19
1223,G17003100630002,1088,1000,88,0.08088,1
484,G17003100102012,4592,3290,1302,0.28354,240
1358,G17003101407021,1852,973,879,0.47462,13
2030,G17003102425002,1832,1077,755,0.41212,5
569,G17003103511003,0,0,0,,1
1901,G17003101502003,1637,854,783,0.47831,51
2224,G17003107002002,1893,1349,544,0.28737,4
233,G17003102801002,1615,1466,149,0.09226,6
485,G17003102106021,1342,956,386,0.28763,1
1258,G17003102832001,1481,1262,219,0.14787,5
2277,G17003107004012,2058,1708,350,0.17007,3
226,G17003105905001,1842,1070,772,0.41911,19
500,G17003106903002,1668,1662,6,0.0036,1
2017,G17003106806002,931,906,25,0.02685,1
13,G17003102609001,981,971,10,0.01019,1
91,G17003103005002,2219,1006,1213,0.54664,3
2058,G17003106810001,620,620,0,0,3
2138,G17003108307003,1323,1006,317,0.23961,106
1605,G17003107004014,920,759,161,0.175,3
540,G17003100315012,1365,923,442,0.32381,264
365,G17003104604004,825,825,0,0,4
532,G17003100301022,835,652,183,0.21916,17
1524,G17003106309002,1322,768,554,0.41906,4
976,G17003104305001,1368,1339,29,0.0212,19
897,G17003102205001,949,773,176,0.18546,2
1522,G17003106403001,1147,795,352,0.30689,3
1599,G17003104402013,897,897,0,0,18
1935,G17003100802023,2093,1772,321,0.15337,3
461,G17003100202004,1736,915,821,0.47293,243
499,G17003106809001,810,803,7,0.00864,2
1874,G17003108366002,1127,964,163,0.14463,1
498,G17003106812003,635,635,0,0,5
994,G17003101201003,542,507,35,0.06458,2
1435,G17003104503001,1603,1584,19,0.01185,28
1184,G17003100321004,1069,711,358,0.33489,17
1186,G17003100608003,3308,2685,623,0.18833,2
2007,G17003106705001,1040,965,75,0.07212,5
673,G17003100705001,872,821,51,0.05849,1
931,G17003102414004,2014,1925,89,0.04419,1
96,G17003108413001,1139,616,523,0.45917,2
2295,G17003107005014,1623,1544,79,0.04868,3
820,G17003101002001,1225,1041,184,0.1502,34
107,G17003104208002,1129,1088,41,0.03632,2
679,G17003102301001,1646,1318,328,0.19927,2
493,G17003102504005,1626,1441,185,0.11378,1
1506,G17003108381002,313,304,9,0.02875,2
775,G17003101611001,988,891,97,0.09818,2
1378,G17003102420001,1583,1293,290,0.1832,4
576,G17003100810001,332,255,77,0.23193,4
1536,G17003100501002,1572,1415,157,0.09987,2
1001,G17003106914003,515,503,12,0.0233,2
759,G17003100409002,675,569,106,0.15704,56
258,G17003106007001,785,468,317,0.40382,12
1183,G17003100315023,1715,1213,502,0.29271,24
2084,G17003100302003,1018,906,112,0.11002,380
966,G17003100704002,936,923,13,0.01389,1
2318,G17003101503006,1042,732,310,0.2975,92
1735,G17003100712002,1076,920,156,0.14498,1
1533,G17003100314003,791,640,151,0.1909,8
1062,G17003108429004,304,210,94,0.30921,13
1889,G17003101402002,1306,510,796,0.60949,30
1626,G17003108391001,3233,2255,978,0.30251,10
164,G17003103206001,2075,1542,533,0.25687,1
704,G17003100715003,1319,1168,151,0.11448,16
78,G17003104908001,724,687,37,0.0511,9
2287,G17003100705003,1026,984,42,0.04094,1
1959,G17003101705003,1348,1045,303,0.22478,7
1107,G17003102302001,1972,1477,495,0.25101,7
100,G17003104206001,1198,1198,0,0,3
1739,G17003101608004,671,423,248,0.3696,1
638,G17003105502002,612,547,65,0.10621,3
158,G17003103016001,2433,1273,1160,0.47678,1
2297,G17003107102004,962,962,0,0,1
403,G17003108105011,812,598,214,0.26355,3
244,G17003104403003,514,514,0,0,2
1657,G17003102411002,2070,1988,82,0.03961,21
2040,G17003100203021,1013,586,427,0.42152,179
1361,G17003101913021,2290,1426,864,0.37729,2
2113,G17003100309003,1055,799,256,0.24265,20
1622,G17003106403004,1839,1497,342,0.18597,9
2126,G17003108350003,1315,887,428,0.32548,2
722,G17003107302015,837,837,0,0,8
1330,G17003102106012,986,558,428,0.43408,1
1157,G17003103108002,1123,680,443,0.39448,1
2180,G17003100407004,761,677,84,0.11038,12
1882,G17003101303002,1027,899,128,0.12463,17
744,G17003101602004,1633,1285,348,0.2131,8
1230,G17003100718001,2065,1753,312,0.15109,82
1430,G17003106915002,1008,1008,0,0,2
1402,G17003104312001,1908,1792,116,0.0608,4
551,G17003101104001,1903,1383,520,0.27325,63
2319,G17003101508002,1029,807,222,0.21574,38
2194,G17003106914001,363,348,15,0.04132,2
1443,G17003105805013,1925,1050,875,0.45455,2
877,G17003100202001,1370,1202,168,0.12263,47
959,G17003102226001,1554,1323,231,0.14865,4
1916,G17003100307062,1303,748,555,0.42594,16
693,G17003100314001,1564,1240,324,0.20716,2
370,G17003106114001,1580,784,796,0.5038,1
1563,G17003108417001,1613,1325,288,0.17855,18
2151,G17003106606001,1151,1072,79,0.06864,5
732,G17003101103002,1319,912,407,0.30857,2
2243,G17003106709001,506,501,5,0.00988,1
299,G17003108343001,982,982,0,0,1
871,G17003102423001,1420,1349,71,0.05,6
329,G17003105305031,1304,1277,27,0.02071,2
2188,G17003106610004,1549,1387,162,0.10458,3
2189,G17003106610005,1475,1408,67,0.04542,11
127,G17003103009002,1447,592,855,0.59088,1
939,G17003105906002,1584,1059,525,0.33144,1
1631,G17003108396002,1083,1018,65,0.06002,40
1422,G17003108390002,2694,2331,363,0.13474,1
1303,G17003103106003,1692,856,836,0.49409,10
439,G17003108057022,745,646,99,0.13289,1
1906,G17003101505023,1705,1264,441,0.25865,13
1568,G17003101907021,845,512,333,0.39408,4
1480,G17003104314001,2496,2468,28,0.01122,15
1338,G17003103301003,6847,5184,1663,0.24288,1
1470,G17003104805002,751,637,114,0.1518,6
1881,G17003101301002,2393,1394,999,0.41747,16
2011,G17003106611005,1594,1194,400,0.25094,1
309,G17003106104001,1897,1053,844,0.44491,7
795,G17003101203002,1339,952,387,0.28902,4
349,G17003108329001,1608,1340,268,0.16667,1
1096,G17003102411001,1945,1416,529,0.27198,9
950,G17003104604001,775,722,53,0.06839,9
799,G17003101204002,1152,807,345,0.29948,38
1974,G17003106118001,1934,1370,564,0.29162,3
1067,G17003103905001,1643,1420,223,0.13573,28
2110,G17003107301003,981,941,40,0.04077,2
1814,G17003102107001,908,604,304,0.3348,1
1962,G17003101907011,1801,1053,748,0.41532,7
156,G17003108408001,1964,1024,940,0.47862,3
2264,G17003100628001,1195,1035,160,0.13389,2
1020,G17003103904001,1139,1139,0,0,6
249,G17003105203001,1719,1117,602,0.3502,2
1446,G17003108330002,1311,1217,94,0.0717,5
430,G17003108055023,1067,971,96,0.08997,12
964,G17003100703002,1263,1139,124,0.09818,1
2205,G17003100409001,1443,1328,115,0.0797,7
316,G17003102520003,1664,1664,0,0,1
132,G17003103201002,2007,1368,639,0.31839,342
1216,G17003108346004,1506,1424,82,0.05445,1
352,G17003102828001,1565,1109,456,0.29137,2
2003,G17003102315006,1926,1910,16,0.00831,1
947,G17003104402011,1227,1227,0,0,22
703,G17003100713001,1465,1345,120,0.08191,7
224,G17003105103003,653,653,0,0,1
735,G17003101103005,1024,569,455,0.44434,34
660,G17003108318001,700,571,129,0.18429,187
1938,G17003106609001,1803,1745,58,0.03217,19
513,G17003100201001,2545,1738,807,0.31709,355
2236,G17003100513002,1400,1304,96,0.06857,10
51,G17003102507001,1074,1074,0,0,1
69,G17003104110001,1386,1203,183,0.13203,3
529,G17003100205002,573,375,198,0.34555,30
203,G17003108342001,889,871,18,0.02025,6
2006,G17003100102013,775,541,234,0.30194,324
870,G17003108310001,892,833,59,0.06614,2
502,G17003106813001,777,759,18,0.02317,2
59,G17003102925002,1862,1837,25,0.01343,5
1013,G17003103818001,788,731,57,0.07234,15
1604,G17003104909011,1771,1726,45,0.02541,1
1807,G17003102004011,954,692,262,0.27463,1
1969,G17003105305032,1775,1708,67,0.03775,3
2048,G17003106406003,1934,1451,483,0.24974,1
1025,G17003104605007,1085,1007,78,0.07189,12
248,G17003105202002,1550,1083,467,0.30129,5
1481,G17003104401021,1233,1232,1,0.00081,6
1507,G17003108378002,1383,1305,78,0.0564,3
207,G17003105103001,1676,1663,13,0.00776,44
1467,G17003104701002,1529,1467,62,0.04055,3
1523,G17003106403002,1015,784,231,0.22759,12
1514,G17003106403003,637,522,115,0.18053,3
1354,G17003104003001,1329,1307,22,0.01655,12
463,G17003102602001,1266,1252,14,0.01106,3
1619,G17003105703004,1716,958,758,0.44172,4
141,G17003104913003,558,547,11,0.01971,3
698,G17003100402014,2243,1763,480,0.214,21
539,G17003100312004,1363,1040,323,0.23698,31
467,G17003102421003,1312,1189,123,0.09375,2
648,G17003101910002,1595,1010,585,0.36677,1
1095,G17003100505001,860,860,0,0,4
1090,G17003100314004,136,95,41,0.30147,42
517,G17003100205003,1526,872,654,0.42857,324
1769,G17003101902004,1033,679,354,0.34269,1
1380,G17003101105022,2228,1622,606,0.27199,19
1349,G17003103801001,1822,1784,38,0.02086,3
342,G17003102508002,1285,1226,59,0.04591,5
854,G17003101504013,1162,824,338,0.29088,8
1442,G17003100307033,1279,1057,222,0.17357,44
2111,G17003100305002,1994,1472,522,0.26179,27
1808,G17003102101001,1381,1130,251,0.18175,5
888,G17003101903003,1361,750,611,0.44893,4
4,G17003102909004,974,974,0,0,11
257,G17003106006001,1728,1029,699,0.40451,18
1409,G17003104909012,1259,1251,8,0.00635,2
613,G17003105611006,912,710,202,0.22149,5
650,G17003108322001,834,780,54,0.06475,5
568,G17003100609004,3564,3068,496,0.13917,5
1520,G17003106309003,1692,996,696,0.41135,12
1166,G17003100315021,1559,981,578,0.37075,36
998,G17003100629001,1415,1335,80,0.05654,4
754,G17003100406001,757,589,168,0.22193,4
2141,G17003100317002,1749,1448,301,0.1721,18
608,G17003104603024,1173,888,285,0.24297,37
364,G17003104604003,551,538,13,0.02359,1
768,G17003101604002,1518,1228,290,0.19104,92
1803,G17003100902004,1841,1513,328,0.17816,57
860,G17003101707003,1062,683,379,0.35687,4
572,G17003106603011,1790,1312,478,0.26704,3
978,G17003101711001,1703,1392,311,0.18262,34
1620,G17003105607002,2171,1231,940,0.43298,15
1576,G17003102206011,680,592,88,0.12941,3
70,G17003104110002,552,518,34,0.06159,2
1932,G17003107306003,1401,1253,148,0.10564,7
2215,G17003106611003,1027,929,98,0.09542,4
1720,G17003101511001,1651,1009,642,0.38886,47
743,G17003101602002,959,558,401,0.41814,14
760,G17003100402021,914,380,534,0.58425,145
829,G17003108312001,846,481,365,0.43144,2
1410,G17003107003023,1528,1179,349,0.2284,14
1750,G17003101703004,1165,877,288,0.24721,12
611,G17003108347003,893,858,35,0.03919,1
2120,G17003106505001,1118,646,472,0.42218,9
1923,G17003106603023,1038,554,484,0.46628,1
895,G17003102203001,1382,1197,185,0.13386,9
1638,G17003107115001,1051,1051,0,0,2
894,G17003102109002,1169,852,317,0.27117,4
105,G17003104207005,447,446,1,0.00224,35
909,G17003100302002,1045,904,141,0.13493,49
1965,G17003102109001,2054,1531,523,0.25463,10
1660,G17003102414002,623,492,131,0.21027,1
510,G17003108339002,981,745,236,0.24057,11
747,G17003108407002,1680,1009,671,0.3994,3
771,G17003101608002,1339,1073,266,0.19866,8
1401,G17003104312002,1383,1316,67,0.04845,10
1259,G17003103103001,1493,1068,425,0.28466,2
1855,G17003101103001,582,475,107,0.18385,14
2178,G17003100406003,1045,903,142,0.13589,1
1371,G17003108318005,1401,850,551,0.39329,525
920,G17003102211001,2003,1764,239,0.11932,7
522,G17003100306032,1010,794,216,0.21386,84
1957,G17003100103002,2200,1669,531,0.24136,57
3,G17003102909003,759,759,0,0,1
201,G17003104308002,727,727,0,0,2
14,G17003102609002,877,877,0,0,3
476,G17003108342002,830,711,119,0.14337,1
1059,G17003106303002,3416,1706,1710,0.50059,1
1431,G17003104402021,1738,1683,55,0.03165,11
1318,G17003108319002,1116,988,128,0.1147,1
859,G17003101707002,806,425,381,0.4727,2
659,G17003102422001,2062,1959,103,0.04995,8
210,G17003108403002,1034,599,435,0.4207,2
2033,G17003102426003,1546,1271,275,0.17788,11
584,G17003108401002,1624,821,803,0.49446,2
1316,G17003100203013,2260,1891,369,0.16327,60
173,G17003104304002,408,399,9,0.02206,21
1168,G17003100511001,1526,1349,177,0.11599,2
878,G17003100204001,693,503,190,0.27417,179
2134,G17003107302011,925,925,0,0,3
792,G17003100901002,1097,947,150,0.13674,13
867,G17003101711002,1339,697,642,0.47946,16
2268,G17003100630001,1324,1138,186,0.14048,6
1034,G17003106202001,887,303,584,0.6584,1
943,G17003100304002,1147,675,472,0.41151,11
1228,G17003100714004,689,628,61,0.08853,1
1294,G17003104307002,957,943,14,0.01463,24
926,G17003102410002,1129,1004,125,0.11072,7
1302,G17003103105001,1722,937,785,0.45587,3
908,G17003100302001,1366,1300,66,0.04832,49
240,G17003104401014,1032,1032,0,0,18
217,G17003108411004,1378,402,976,0.70827,1
538,G17003100313002,1305,1145,160,0.12261,99
925,G17003102216002,1799,1450,349,0.194,5
2283,G17003107505002,1019,1019,0,0,3
2209,G17003100503001,995,835,160,0.1608,1
